Car Wash - Sharktale
De Pinguïndans - Schiffie & Co
Vamos a la Playa - Loona
Ocean - Martin Garrix & Khalid
Boten Anna - Gebroeders Ko
Ferry de Roze Flamingo - Barry Fest & Tim Schalkx
I Am The Walrus - The Beatles
Wim De Blauwe Pelikaan - Tim Schalkx
Roei De Boot - Sportpiet
No Ordinary Girl - H2O: Just Add Water
Ik Wil Alleen Maar Zwemmen - Spinvis
Visje visje in het water - Kinderliedjes
Mermaid - Train
Its Raining Men - The Weather Girls
Dansen Aan Zee - Blof
ocean eyes - Billie Eilish
Wij Gaan Duiken - Piet Piraat
Kom maar Vissie - Buurman&Buurman
Lose Control - Teddy Swims
Underwater - RONDÉ
Aquarius - Party Animals
Vissen - Mooi Wark
Jaws theme - John Williams
Ships + Tides - OneRepublic
Aan De Kust - Blof
Just Keep Swimming - Finding Nemo
Love is All Around - Wet Wet Wet
Oesters & Champagne - Teske
Aan Zee - Nielson
Ik Ben Een Zeehond - Huub Hangop
Wellerman Sea Shanty - Nathan Evans
Drijfzand - Froukje
Cold Water - Major Lazer, Justin Bieber, MO
The River - Bruce Springsteen
