Wannabe - Spice Girls
Hotter Than Hell - Dua Lipa
Bootylicious - Destiny’s Child
Espresso - Sabrina Carpenter
Juicy - Doja Cat
Eternal Flame - The Bangles
Wim De Blauwe Pelikaan - Tim Schalkx
Spice Up Your Life - Spice Girls
Pittige Tijden - Carlo & Irene
LIT - Famke Louise, LouiVos
I Wanna Dance with Somebody - Whitney Houston
Rather Be - Clean Bandit, Jess Glynne
Swalla - Jason Derulo, Nicki Minaj & Ty Dolla $ign
Sappig - Makkie, Ambassadors
Fireball - Pitbull, John Ryan
Het Bananenlied - De Boswachters
I’m Too Sexy - Right Said Fred
Let’s Talk About Sex - Salt-N-Pepa
Sgt. Peppers Lonely Hearts Club Band - The Beatles
Twee Motten - Dorus
Burning Daylight - Mia Nicolai, Dion Cooper
Fuego - Eleni Foureira
Firestarter - The Prodigy
Burning Up (Fire) - BTS
Horny - Mousse T., Hot ‘N’ Juicy
PPAP (Pen-Pineapple-Apple-Pen) - PIKOTARO
Apple - Charli xcx
Dat Zijn De Peppers - Kabouter Plop
Exotica - Parcels
Roses - benny blanco, Juice WRLD feat. Brendon Urie
Applejack - Dolly Parton
Kip, Patat en Appelmoes - Kinderen voor Kinderen
Apple Bandit - Funk McLovin
Pittige Peper - In de Volksmond
I See Fire - Ed Sheeran
O Holy Night - Chef
Burning Heart - Survivor
BURN IT DOWN - Linkin Park
The Flame - Cheap Trick
