Feeling Hot Hot Hot - The Merrymen
Watermelon Sugar - Harry Styles
Apple Juice - Teddy Swims
Fire - The Pointer Sisters
Voulez-Vous - ABBA
Ferry de Roze Flamingo - Barry Fest
Drink Juice - Horsepowar
Habiba - Boef
Pepperpot - Sean Paul
Spice Up Your Life - Spice Girls
Krokobil - Yellow Claw
Juice - Lizzo
Hot Stuff - Donna Summer
Relight My Fire - Dan Hartman
SPICY - Alessia
Raspberry Beret - Prince
Burn - VanVelzen
Appel, Peertje en Banaan - Lil Ones, Faske 
Heet Heet Heet - Kabouter Plop
Tweede Kamer - Sophie Straat, Goldband
Burn - Anouk
Kruidig & Pittig - Opgezwolle
You Sexy Thing - Hot Chocolate
Cheers (Drink To That) - Rihanna
Flames - David Guetta, Sia
Drinken Is Ook Sport - De Sfeermakers
Empire State Of Mind - JAY-Z
September - Earth, Wind & Fire
Pizza Calzone - Enge Buren
Fruitsalade - Jeroen Schipper
Quente, Quente, Quente - Doce
BITE THE APPLE - Claudia Bouvette
Pepper Box - The Peppers
Home - Edward Sharpe & The Magnetic Zeros
Peperempe - Da Posh, Pepper
Freak Me - Another Level
Fire - Jimi Hendrix
Burning - Lewis Capaldi
Dancing In The Flames - The Weeknd
