Juicy Wiggle - Redfoo
Hot - INNA
Californication - Red Hot Chili Peppers
Pina Colada - K3
Vamos a la Playa - Loona
Hot In Herre - Nelly
I Know You Want Me - Pitbull
Proosten - Guus Meeuwis
Girl on Fire - Alicia Keys
Hot for Teacher - Van Halen
Lied Van De Vos - De 3 Biggetjes
Jè Bent Ut Voâh Mèn - De Règâhs
Raise Your Glass - P!nk
Firework - Katy Perry
Set Fire To The Rain - Adele
Too Hot - Kool & The Gang
Sexbomb - Tom Jones
Blurred Lines - Robin Thicke
Dark Horse - Katy Perry, Juicy J
Moth To A Flame - Swedish House Mafia
I’m On Fire - Bruce Springsteen
Spicy Margarita - Jason Derulo, Micheal Bublé
Omlaag - Gio, Keizer, Freddy Moreira
Bubbelbad - Tim Schalkx
Peaches - Justin Bieber, Daniel Caesar & Giveon
Drop It Like It’s Hot - Snoop Dogg
The Fox (What Does The Fox Say) - Ylvis
Surf - Bam Bam Papi, Lucci, Defano Holwijn
Apples, Peaches, Bananas and Pears - The Monkees
Pepper - Death Cab for Cutie
Gin and Juice - Snoop Dogg
Appel Mint Puur - Broederliefde
WAP - Cardi B, Megan Thee Stallion
Get Me Ready - Pepper
Chocolate Salty Balls - Chef
Burning Love - Elvis Presley
Beds Are Burning - Midnight Oil
Firefighter - Nutsa
